111111111
101CC1CC1
11CCCC011
1PCCC1CE1
111111111