11111
1C0E1
10001
10001
10P01
11111